11111111111111111
1P000000000000001
11111111011111101
100000C0000000101
10111111111111101
10000000000000001
11111111111111101
10000000000000001
11111111111111101
10000000000000001
11111111111111101
1000C000000000001
100000000000000E1
11111111111111111
