11111111111111111
1P00000000000C001
11111111111111101
1000000000C000001
10111111111111111
100C0000000000C01
11111111111111101
10000000000000001
11111111111111101
10000000C00000001
11111111111111101
10000000000000001
1000C0000C00000E1
11111111111111111
