11111111111111111
10000000PC0000001
11111111011111101
10000000000000101
1C111111111111101
10000000000000001
11110111111111101
1000000000C000001
11110111111111111
1C000000000000001
11111111111111101
1000000C000000001
10E00000000000001
11111111111111111
