11111111111111111
10000000000000001
11111111011111101
10000000000000101
1C111111111111101
10000000000000001
11111111111111101
10000000000000001
11111111111111101
10000000000000001
11111111111111101
10000000000000001
10EPC000000000001
11111111111111111
