11111111111111111
1000000PC01000001
11111111101111111
10000E00000000101
11111111111111111
