11111111111111111
1000000PC01000001
11111111101111111
10000E00001000101
11111100000111111
11111100000000C01
10000000000000Cc1
11000000100000C01
11111111111111111
