11111111111111111
10000000000000001
1010C101001010101
10100100111011111
1E0000000C100P001
11111111111111111