11111111111111111
1P000000000000001
11111111011111101
10000000000000101
1C111111111111101
10000000000000001
11111111111111101
10000000000000001
11111111111111101
10000000000000001
11111111111111101
10000000000000001
10E00000000000001
11111111111111111
